00000000000000000000
00000000000000000000
00000000000000000000
00010000000000000000
00010000000000001000
00010000000000000000
00010000000000001000
00010000000000001000
00011111000000001000
00000001000000001000
00000001000000001000
00000001000000001000
00000001001111111000
00000000000000000000
00000000000000000000
00000000000000000000
00000000000000000000
00000000000000000000
00000000000000000000
00000000000000000000
